aa		aa
aacaarya	aa c aa r y a
aadhaara	aa dh aa r 
aadhaarashilaa	aa dh aa r a sh i l aa
aadhii		aa dh ii
aadivaasii	aa d i w aa s ii
aaiisiiesaii	aa ii s ii ee s a ii
aaja		aa j aa
aajaqada	aa z aa d
aakaasha	aa k aa sh
aakhira		aa kh i r
aakrusxtxa	aa k r u sx tx
aalasii		aa l s ii
aapane		aa p n ee
aaqdolana	aa n d o l a n
aarambha	aa r a m bh
aashcarya	aa sh c a r y
aashiirvaada	aa sh ii r w aa d
aastiina	aa s t ii n
aavaaja		aa w aa j
aayaa		aa y aa
aayii		aa y ii
aba		a b
abhuutapuurva	a bh uu t a p uu r w
acchaa		a c ch aa
acchii		a c ch ii
adhikaaqs	a dh i k aa nj sh
adhikaaqsha	a dh i k aa nj sh aa
advitiiya	a d w i t ii y 
agale		a g a l ee
aksara		a k s a r
alabattaa	a l a b a tt aa
alookika	a l au k i k 
alpasaqkhyaka	a l p a s a ng kh y a k
ammaa		a mm aa
amruta		a m r u t 
amuulya		a m uu l y 
anuccheda	a n u c ch ee d
anucheda	a n u c ch ee d
anusaara	a n u s aa r
anya		a n y
apanaa		a p a n aa
apane		a p n e
apanii		a p n ii
aparaadhii	a p r aa dh ii
apsaraaoq	a p s a r aa on
ashubha		a sh u bh
baabaa		b aa b aa
baada		b aa d
baagha		b aa gh
baaghoq		b aa gh on
baahara		b aa h a r
baaki		b aa k i
baalaka		b aa l a k
baalikaaoq	b aa l i k aa on
baaraha		b aa r a h
baare		b aa r e
baata		b aa t 
baataciita	b aa t a c ii t
bacapana	b a c a p a n 
baccoq		b a cc on
badala		b a d a l
badxaa		b a dx aa
badxae		b a dx ee
badxaii		b a dx a ii
badxaqa		b a dx aa
badxhaeqge	b a dxh aa ee ng g ee
badxhaqte	b a dxh a t ee 
bahaneq		b ee h n ee
bahuta		b a h u t
banaa		b a n aa
banii		b a n ii
bapootii	b a p au t ii
baqdhaayaa	b a n dh aa y aa
baqdhu		b a ng dh u
baraata		b aa r aa t 
barasa		b a r a s
bartana		b a r t a n
basaa		b a s aa
behataashaa	b ee h a t aa sh aa
behatara	b ee h a t a r 
beitxhe		b ei txh ee 
beitxhii	b ei txh ii	
betxara		b e tx a r
bhaaga		bh aa g
bhaage		bh aa g e
bhaamqtii	bh aa ng t i
bhaarata	bh aa r a t
bhaasxaa	bh aa sx aa
bhaatii		bh aa t ii
bhagata		bh a g a t
bhagatajii	bh a g a t a j ii
bhagavaan	bh a g a w aa n
bhagavaana	bh a g w aa n 
bhara		bh a r 
bhare		bh a r ee
bhedxaiyoq	bh e dx i y on
bheja		bh e j 
bhii		bh ii
bhuula		bh uu l 
bhuumi		bh uu m i
bhuuta		bh uu t
biica		b ii c 
biijoq		b ii j on
biimaarii	b ii m aa r ii
biisa		b ii s 
bijaliyaamq	b i j l i y aan
bilakula	b i l k u l
bistara		b i s t a r
bolaa		b o l aa	
bolate		b o l t ee
botala		b o t a l
bulaayaa	b u l aa y a
buudxhaii	b uu dxh ii
buunda		b uu n d
byaaja		b y aa j	
caahataa	c aa h a t aa
caahatii	c aa h a t ii
caahie		c aa h i ee
caara		c aa r
caava		c aa w
caaya		c aa y 
cadxdxaa	c a ddx aa
cadxdxhaa	c a ddx aa
cadxhaqa	c a dxh aa
cadxhe		c a dxh a
cale		c a l ee	
calegaa		c a l e g aa
calii		c a l ii
calo		c a l o	
capadxaq	c a p a dx 
caraagaahoq	c a r aa g aa h on
catura		c a t u  r
cavannii	c a w a n n ii
chaha		ch a h a
chatipuurti	ch a t i p uu r t i
chatxhaa	ch a txh aa
chodxaq		ch o dxq
chodxaqa	ch o dxq aa
chotxaa		ch o tx aa
ciikha		c ii kh
coodharii	c ou dh r ii
cookaa		c ou k aa
coothe		c ou th ee
cotxa		c o tx
cubhanaa	c u bh a n aa
cupa		c u p
cuudxaqamanxi	c uu dxq aa m a nx i
cuuq		c uun
daastaana	d aa s t aa n
dahaadxaq	d a h aa dxq
daksxinxa	d a k sx i nx
dara		d a r
daravaaje	d a r w aa j ee
dasa		d a s
dabaava		d a b aa w
de		d ee
deivii		d ei w ii
dekha 		d ee kh
dekhaa		d ee kh aa
dekhabhaala	d ee kh a bh aa l
dekhakara	d ee kh a k a r
dekhate		d ee kh t ee
dekhatii	d ee kh t ii
dekho		d ee kh o
denaa		d ee n aa
dene		d ee n
desha		d ee sh
deshabhara	d ee sh a bh a r
detaa		d ee t aa
detii		d ee t ii
dhaaranxaa	dh aa r a nx aa
dhanii		dh a n ii
dhanurdhaarinxii dh a n u r dh aa r i nx ii	
dharma		dh a r m
dhiiraja	dh ii r a j
dhiire		dh ii r ee
dhobina		dh o b i n
dhulavaakara	dh u l w aa k a r
dhyeya		dh y ee y
dii		d ii
diipacaqda	d ii p a c a n d axx
diivaanajii	d ii w aa n j ii
dikhaa		d i kh aa
dikhaaii	d i kh aa ii
dikhaayii	d i kh aa y ii
dila		d i l
dimaagii	d i m aa g ii
dina		d i n
dinoq		d i n on
diyaa		d i y aa
do		d o
donoq		d o n on
doodxaqkara	d au dx a k a r
doore		d au r ee
dopahara	d o p a h a r
dostii		d o s t ii
drushya		d r u sh y a
drusxtxi	d r u sx tx i
dukhii		d u kh ii
duudha		d uu dh
duura		d uu r
duusaraa	d uu s a r aa
dxaakasevaa	dx aa k a s ee w aa
dxaalakara	dx aa l k a r a
dxaale		dx aa l ee
dxedxhaq	dx ee dxhq
eicchika	ei cch i k
eisaa		ei s aa
eise		ai s ee
eka		e k
ekadama		e k a d a m
ekadxaq		e k a dxq
gaamqva		g aan w
gaamqva		g aa on
gae		g a ee
gaii		g a ii
gale		g a l ee
gaqguu		g a ng g uu
garimaa		g a r i m aa
gatxhana	g a txh a n
gayaa 		g a y aa
gayii		g a y ii
ghaasa		gh aa s
ghaata		gh aa t
ghaayala	gh aa y a l
ghamaqdxii	gh a m a n d ii
ghaqtxe		gh ax t ee
ghara		gh a r
ghatxanaa	gh a tx a n aa
ghatxita	gh a tx i t
ghiisuu		gh ii s uu
ghodxe		gh o dx ee
ghosxanxaa	gh o sx nx aa
ghosxita	gh o sx i  t
ghuse		gh u s ee
ghutxa		gh u tx
ghuumakara	gh uu m k a r
gira		g i r
girane		g i r aa n e
girjaaghara	g i r j aa gh a r
gola		g o l
gurudeva	g u r u d ee v
haatha		h aa th
hajaara		h a j aa r
hama		h a m
hamaaraa	h a m aa r aa
hamaare		h a m aa r ee
hamaarii	h a m aa r ii
harii		h a r ii
hei		h ei
heiq		h ei n
hii		h aa y
hinduu		h i n d uu
hiqdii		h i n d ii
ho		h o
hogaa		h o g aa
hogii		h o g ii
hone		h o n ee
hoq		h on
hotaa		h oo t aa
hote		h o t ee
hotii		h o t ii
huaa		h u aa
hue		h u ee
huumq		h oo n
huyii		h u ii
icchaa		i cchx aa
idhara		i dh a r
iiqtxe		ii nx tx ei
iirsxyaa	ii r sx y aa
iishvara	ii sh v a r
ika		ee k
ikatxhtxhii	i k a ttxh ii
inakaa		i n k aa
iqgleiqdxa	i ng l ei nx dx
iqsaana		i n s aa n
isa		i s
isake		i s a k ee
isakii		i s a k ii
isalie		i s l i ei
isameq		i s m en
isase		i s s ee
ise		i s ee
isiilie		i s ii l i ee
ispaata		i s p aa t
itanaa		i t a n aa
itane		i t a n e
itanii		i t a n ii
itihaasa	i t i h aa s
jaa		j aa
jaae		j aa ee
jaaegii		j aa ee g ii	
jaakara		j aa k a r	
jaana		j aa n
jaanaa		j aa n aa
jaane		j aa n ee
jaataa		j aa t aa
jaate		j aa t ee
jaatii		j aa t ii
jaatiyoq	j aa t i y on
jaauumqgaa	j aa uu ng g aa
jaaye		j aa y ee
jaba		j a b
jagaha		j a g a h
jagata		j a g a t
jagatpati	j a g a t a p a t i
jailoq		j i l on
jaiqdagii	z i nx d a g ii
janavarii	j a n a w a r ii
jaqgala		j a ng g a l
jaqraa		z a r aa
jaruura		j a r uu r
javaaba		j a v aa b
jeise		j ei s ee
jhuutxhaa	jh uu txh aa
jhuutxhe	jh uu txh ei
jhuutxhii	jh uu txh ii
jiitaa		j ii t aa
jiivana		j ii v a n
jiivita		j ii v i t
jijnyaasaa	j i g y aa s aa
jisase		j i s a s ee
jo		j o
juunuuna	j u n uu n
jyaadaa		j y aa d aa
kaa		k aa
kaala		k aa la
kaama		k aa m
kaamqtxaa	k aa nx tx aa
kaaphii		k aa ph ii
kaaqgresa	k aa ng r e s
kaaranxa	k aa r a nx
kaaryakartaaoq	k aa r y a k a r t aa on	
kaatxa		k aa tx
kaatxaa		k aa tx aa
kaauqtxaroq	k aa u nx tx a r on
kabhii		k a b h ii
kabuutaroq	k a b uu t a r on
kacce		k a cc ee
kadxaii		k a dx aa ii
kaha		k a h a
kahaa		k a h aa
kahaanii	k a h aa n ii
kahakara	k a h a k a r
kahane		k a h a n ee
kahiiq		k a h iin
kaho		k a h o
kaii		k a ii
kalaa		k a l aa
kalara		k a l a r
kanaatxa	k a n au tx
kapadxe		k a p a dx ee
kaqtla		k a t l	axx
kara		k a r
karanaa		k a r a n aa
karane		k a r a n ee
karate		k a r a t ee
karuumqgaa	k a r uu mq g aa
kasootxii	k a s ou tx ii
kathana		k a th a n
katxaghara	k a tx gh a r
katxe		k a tx ee
ke		k ee
keidii		k ei d ii
keqdriiya	k ee ng d r ii y
kevala		k ee v a l
khadxae		kh a dx ee
khadxaqa	kh a dx aa
khanxdxa	kh a nx dx
khariidaa	kh a r ii d aa
khariidate	kh a r ii d a t ee
khela		kh ee l
khetii		kh ee t ii
khilaapha	kh ii l aa ph
khoja		kh o j
khuda		kh u d
ki		k i
kii		k ii
kiijiye		k ii j i y ee
kisa		k i s
kishtoq		k i sh t on
kisii		k i s ii
kiyaa		k i y aa
kiye		k i y ee
ko		k o
koii		k o ii
koovaa		k au w aa
kosa		k o s
kosoq		k o s on
kotxhii		k o txh ii
koyalaa		k o y a l aa
krusxi		k r u sx i
kuaamq		k u aan
kucha		k u ch
kushalataa	k u sh a l t aa
kyaa		k y aa
kyoq		k y on
laadxa		l aa dx
laakha		l aa kh
laalamanxi	l aa l a m a nx i
laaqdxrii	l au nx dx r ii
ladxaqkii	l a dx k ii
ladxaqkiyoq	l a dx k i y on
lagaa		l a g aa
lagaae		l a g ee
lagabhaga	l a g bh a g
lagatii		l a g a t ii
lage		l a g ee
lagii		l a g ii
lajjita		l a jj i t
lambaaii	l a m b aa ii
lekara		l ee k a r
lene		l ee n ee
lie		l aa ii
likhe		l i kh ee
lipatxa		l i p a tx
lo		l o
loga		l o g a
lohe		l o h ee
lokakalaa	l o k k a l aa
lutxeroq	l u tx ee r on
maadaka		m aa d a k
maadhava	m aa dh a w
maakapaa	m aa k a p aa
maaluuma	m aa l uu m
maamalaa	m aa m a l aa
maanava		m aa n a w
maane		m aa n ee
maanii		m aa n ii
maaxla		m aa l
madhushaalaa	m a dh u sh aa l aa
magara		m a g a r
mahaaraaja	m a h aa r aa j a
mahaaraajaa	m a h aa r aa j aa
mahaaraanii	m a h aa r aa n ii
mahaaraanxaa	m a h aa r aa nx aa
mahala		m a h a l
mahattvapuurnxa	m a h a tw a p uu r nx a
mahatva		m a h a tw
mahiinaa	m a h ii n aa
mahiine		m a h ii n ee
mahilaa		m a h i l aa
majabuura	m a j a b uu r
makaana		m a k aa n
mamqje		m a nj jh ee
mana		m a n
mandiroq	m a n d i r on
manusxya	m a n u sx y
manxipurii	m a nx i p u r ii
maqdxala	m a ng dx a l
maqdxapa	m a ng dx a p
maqgala		m a ng g a l
maqtrii		m a n t r ii
marammata	m a r a mm a t
mata		m a t
megha		m ee gh
meine		m ei n ee
meiq		m ei n
meiqne		m ei n ee
meq		m ee n
mere		m ee r ee
miila		m ii l
miinaara	m i n aa r
mila		m i l aa
milataa		m i l a t aa
milate		m i l a t e
mishra		m i sh r
mitrataa	m i t r axx t aa
mitroq		m i t r on
mitxtxii	m i ttx ii
modii		m o d ii
mohara		m o h a r
mujhe		m u jh ee
mukhiyaa	m u kh i y aa
mukhya		m u kh y
murkha		m uu r kh a
mutxhabhedxaq	m u txh bh ee dx
muulyoq		m uu l y on
muurtiyoq	m uu r t i y on
na		n a
naa		n aa
naagra		n aa g a r
nae		n a ee
nahii		n a h ii n
nahiiq		n a h ii n
namuune		n a m uu n ee
ne		n ee
nigaaha		n i g aa h
nikala		n i k a l
nikatxa		n i k a tx
nirbhara	n i r bh a r
nirnxaya	n i r nx a y
nivesha		n i v ee sh
noo		n ou
noojavaana	n ou j a v aa n
nyaaya		n y aa y
oora		ou r
oorata		ou r a t
ora		o r
paakhaqdxii	p aa kh a nx dx ii	
paamqca		p a ng kh aa
paanii		p aa n ii	
paaqca		p aa ng c
paartxii	p aa r tx ii
paasa		p aa s aa
pacaasa		p a c aa s
pacaraqgii	p a c r a n g ii
padaartha	p a d aa r th
padxaa		p dxhq aa
padxaqtaa	p dxhq aa t aa
padxhaqa	p dxhq ng aa
padxhaqate	p dxhq aa t ei
padxii		p dxhq ii
pahacaana	p e h ch aa n aa	 
pahacaananaa	p e h ch aa n n aa
pahale		p a h l ei
pahanuuqgii	p e h ei n u n g ii
pahumqce	p a h u n c ei
pakkaa		p a kk aa
pakkii		p a kk ii
paqjaaba	p a nj j aa b
para		p a r
parinxaama	p a r ii nx aa m
pashcima	p a sh c i m
pataa		p a t aa	
patiyoq		p a t ii y on
patra		p a t r
patxasana	p a t s aa n
patxavaa	p a t w aa
pedxaq		p ee dxq
peidaa		p ei d aa
peiqtare	p ei n t r ee
peira		p ei r
pheiktxarii	p i c k aa r ii
phira		ph i r
phoorana	p uu r aa n aa
phutxa		ph uu txh
pichavaadxae	p ii ch w aa d ei
piinaa		p ii n aa
plesa		p l ee s
praaciina	p r aa c ii n
pradarshana	p r a d a r sh a n
pradesha	p r a d ei sh
pradhaana	p r a d aa n
prashaashana	p r a sh aa sh a n
pratisxtxhaa	p r a t ii k jhq aa
prativarsxa	p r a t ii w a r sh
prema		p r ee m
preranxaa	p r ee r nx aa
priqsa		p a r ii k sh aa
prkaara		p r a k aa r
prukruti	p r a k r i t ii
punarjiivita	p uu n a r j ii w i t
puraanaa	p uu r aa n aa
puujaa		p uu j aa
puure		p uu r ee
puurii		p uu r ii
puurnxa		p uu r nx
puurva		p uu r w
pyaara		p y aa r aa
raaja		r aa j
raajaa		r aa j aa
raajya		r aa j y
raashi		r aa sh ii
raata		r aa t
raatoq		r aa t on
ragadxaqa	r a g a dxq aa
rahaa		r a h aa
rahanaa		r a h n aa
rahataa		r a h t aa
rahatii		r a h t ii
rahe		r a h ee
rahii		r a h ii
rakhaa		r a kh aa
rakhane		r a kh n ei
rakhate		r a kh t ei
rakhii		r a kh ii
rasa		r a s
rishte		r i sh t ei
riyaasata	r i y aa s a t
rupayaa		r uu p y aa
ruupa		r uu p
ruupakumaarii	r uu p a k u m aa r ii
saadhana	s aa dh a n aa
saaga		s aa g
saahasa		s aa h a s
saahasii	s aa h a s ii
saakha		s a kh aa
saala		s aa l
saamane		s aa m a n ei
saapha		s aa ph
saaraa		s aa r aa
saata		s aa t
saatha		s aa th
saba		s a b
sabase		s a b s ee
sabuuta		s aa b u t
sacamuca	s a c m u c
saccaaii	s a cc aa ii
saccii		s a cc ii
sacetaka	s a c ee t a k
sadana		s aa dh n aa
sadxaqka	s a dxq a k
sahakaarii	s a h a k aa r ii
sakate		s a k t ei
samaacaara	s a m aa c aa r
samaapta	s a m aa p t axx
samajha		s a m a jh
samaya		s a m a y
sambandhii	s a m b a n dh ii
sammmaana	s aa m aa n
samruddha	s a m r u dh
samruddhi	s a m r a dh ii
saqbhava	s a m bh a v
saqghatxana	s a ng gh a txh a n
saqgrahaalaya	s a ng g r aa l a y
saqkalpa	s a ng k a l p
saqkatxamocana	s a n k a tx a m o c a n
saqketa		s a n k ei t
saqsthaana	s a n s th aan
saqtusxtxa	s a n t u sx tx axx
saqvidhaana	s a m v ii dh aan
sarakaara	s a r k aa r
sashakta	s a sh a k t axx
sastii		s a s t ii
sattaa		s a tt aa
savere		s a v ei r ei
se		s ei
sela		s ei l
setxhajii	s ei txh a j ii
setxhanii	s ei txh aa n ii
shaadii		sh aa d ii
shaama		sh aa m
shabda		sh a b d axx
shakla		sh a k l axx
shava		sh a v
sheilii		sh ei l ii
shekhacillii	sh ei kh c i ll ii
shilpa		sh i l p axx
shivaalaya	sh i v aa l y axx
shresxtxha	sh r e sx txh axx
shrruqgaara	sh rr i n g aa r
shuruu		sh u r u
sii		s ii
siimaabandii	s ii m aa b a n d ii
skuula		s k uu l
so		s o
socaa		s o c aa
sokara		s o k a r
soo		s oo
sooqdarya	s oo n d a r y axx
spasxtxa	s p a sx tx axx
staqbhoq	s t a m bh on
stara		s t a r
sthaana		s th aa n
stxiilsa	s tx ii l s
subaha		s u b a h
sukha		s u kh
sukhii		s u kh ii
sunaayii	s u n aa y ii
sundara		s u n d a r
suqdaralaala	s u n d a r a l aa l
suqdarii	s u n d a r ii
suucanaa	s uu c n aa
suukhaa		s uu kh aa
svabhaava	s w a bh aa w
svara		s w a r
taalaabaqdii	t aa l aa b a n d ii
taalamela	t aa l m e l
taaqkhula	t aa kh u l
taba		t a b
taka		t a k
taraha		t a r a h
tathaa		t a th aa
tatvoq		t a t v on
teiyaara	t ei y aa r
thaa		th aa
thaapatii	th aa p a t ii
the		th ee
theile		th ei l ee
thii		th ii
thiiq		th iin
thodxae		th o dx ee
tiina		t ii n
tiira		t ii r
to		t o
tumhaarii	t u m h aa r ii
turanta		t u r a n t
turaqta		t u r a n t
tuu		t uu
txhaakura	txh aa k u r
txhappa		txh a p axx
txhaqdxii	txh ng dx ii
txiivii		tx ii v ii
txikaa		tx i k aa
txukadxe	tx u k a dx ee
tyaaga		t y aa g
uccakotxi	u ccx a k oo tx i
ucita		u c i t
udhara		u dh a r
udxaiisaa	u dxq ii s aa
udyoga		u d y o g
udyogoq		u d y o g on
uge		u g ee
ujaalii		u j aa l ii
una		u n
unake		u n k ee
unakii		u n k ii
unako		u n k on
unase		u n s ee
unheq		u n h ee
unhoqne		u n h o n ee
upaaya		u p aa y
upabhoktaaoq	u p a bh o k t aa on
upadesha	u p a d ee sh a
upajaauupana	u p a j aa uu p a n
upalabdha	u p a l a b dh axx
usa		u s
usakii		u s k ii
usame		u s m ee
usane		u s n ee
usase		u ss ee
use		u s ee
utpaadana	u t p aa d a n
uttara		u tt a r
utxhaakara	u tx h aa k a r
utxhatii	u tx h a t ii
uumqcaa		uu nj c aa
uumqcaaii	uu nj c aa ii
uumqce		uu nj c ee
uumqcii		uu nj c ii
uupara		uu p a r
uuparii		uu p a r ii
vaalii		w aa l ii
vaastava	w aa s t a w
vaastushilpa	w aa s t u sh i l p
vaha		w a h
vahaamq		w a h aan
vahii		w a h ii
vakata		w a k t
varadaana	w a r d aa n
varsxa		w a r sx aa
vasiiyata	w a s ii y a t
vastra		w a s t r axx
vastueq		w a s t u ein
vasuula		w a s uu l
ve		w ee
veibhava	w ei b h a w
veijnyaanika	w ei g y aa n i k
vidyaa		w i d y aa
vikramaaditya	w i k r a m aa d i t y a	
vilaksxanxa	w i l a k sh a nx
vishvaasa	w i sh w aa s
vishvaasaghaata	w i sh w aa s gh aa t
vivaaha		w i w aa h
vruksxa		w r i k sx axx
vyaahii		b y aa h ii
vyaapaarii	w y aa p aa r ii
vyaktiyoq	w y a k t i y on
vyasta		w y a s t axx
vyathita	w y a th i th
vyavasthaa	w y a w a s th aa
yaada		y aa d
yaanii		y aa n ii
yaha		y a h
yahaamq		y a h aan
yahii		y a h ii
yasa		y a sh
yoddhaa		y o ddh aa
yuga		y u g
sil		sil
!SIL		sil
